E...E...E...E...
.SSSSS.B.SSSSS..
.S...B.B.B...S..
.S.B.B.B.B.B.S..
.S.B.B.B.B.B.S..
.S.B.BBBBB.B.S..
..........B....
TTTT.B.B.B.TTTT.
TTTT.B.B.B.TTTT.
WWWW.B.....WWWW.
.....B.B.B.B....
.B.B.B.B.B.B.B..
1B.B.B...B.B.B2.
.B...BBXBB...B..
.................
IIIIII.....IIIII