E.E.E.E.E.E.E.E.
SSSSS.....SSSSS.
S...SBBBBS...SS.
S.S.S...S.S.SS.S
S.S.S.S.S.S.SS.S
S.S.S.S.S.S.SS.S
S.S.S.S.S.S.SS.S
S.S.S.S.S.S.SS.S
S.S.S.S.S.S.SS.S
S.S.S.S.S.S.SS.S
S.S.S.S.S.S.SS.S
S.S.S...S.S.SS.S
S...SBBBBS...SS.
SSSSS.....SSSSS.
1..............2
TBBBBB.BXBB.BBBT