E...........E..
.BBBB...BBBB...
.B...BBB...B...
.B.B.....B.B...
.B.BBBSBBB.B...
...B.....B.....
BBB.......BBB..
WTTTTT.TTTTTW..
W...............
.BBBB...BBBB...
.B...BBB...B...
1...........2..
....BBXBB......
...............
...............
...............