E.E.E.E.E.E.E.E.
.S...........S..
..B.TTTTTTT.B...
.S.B.......B.S..
..B.B.WWW.B.B...
.S.B.W...W.B.S..
..B.W.BSB.W.B...
.S.W.B...B.W.S..
..W.B.BSB.B.W...
.S.B.B...B.B.S..
..B.BBBSBBB.B...
.S.B.......B.S..
..B.TTTTTTT.B...
.S...........S..
1..............2
.BBBB...BXXB....