E...........E...
.BWWWWWWWWWWB...
.B...........B..
.B.BBBBBBBBB.B..
.B.B.......B.B..
.B.B.SSSSS.B.B..
.B.B.S...S.B.B..
.B.B.S.T.S.B.B..
.B.B.S...S.B.B..
.B.B.SSSSS.B.B..
.B.B.......B.B..
.B.BBBBBBBBB.B..
.B...........B..
.BBBBBBBBBBBBB..
1....2..........
IIIIIIIBBXXXBBII