E...........E....
.BBBB...BBBB.....
.B...BBB...B.....
.B.B.....B.B.....
.B.BBBSBBB.B.....
...B.....B.......
BBB.......BBB....
WTTTT...TTTTWW...
W...............W
.BBBB...BBBB.....
.B...BBB...B.....
1...........2....
....BBXBB........
.................
.BBB.......BBB...
SSSSS.....SSSSS..